0000000000000000000
0000000000000000000
0000000000000000000
0000WWWWW0000000000
0000W---W0000000000
0000WX--W0000000000
00WWW--XWW000000000
00W--X-X-W000000000
WWW-W-WW-W000WWWWWW
W---W-WW-WWWWW--BBW
W-X--X----------BBW
WWWWW-WWW-WOWW--BBW
0000W-----WWWWWWWWW
0000WWWWWWW00000000
0000000000000000000
0000000000000000000
